X	X	X	X	X	X	X	X	X	X	X	X	X	X	X	X	X	X	X	X	X	X	X	X	X	X	X	X	X	X	C	X	X	X	X	X	X	X	X	X
X	Z	Z	Z	O	O	X	O	F	O	X	C	X	K	A	H	Z	O	X	Z	O	O	O	O	Z	X	X	X	X	X	O	X	O	O	O	O	O	O	P	X
X	Z	Z	Z	O	O	X	O	F	O	X	H	X	X	X	X	X	O	O	O	F	O	F	F	O	X	O	O	O	O	O	X	O	F	F	F	F	F	F	X
X	X	X	X	X	A	X	O	F	O	O	O	X	C	X	H	X	O	X	O	F	O	O	F	O	O	O	F	F	F	O	O	O	F	C	T	O	D	O	X
X	Z	O	O	O	O	O	O	F	O	X	X	X	Z	X	s	X	X	X	O	F	F	O	F	F	F	F	F	H	X	X	X	X	F	Z	Z	Z	F	O	X
X	A	X	O	O	O	O	Z	F	O	O	O	A	S	X	s	D	O	O	O	O	O	Z	O	O	O	O	O	Z	X	K	X	K	F	F	F	F	F	O	X
X	H	X	O	O	O	X	Z	X	F	X	X	X	X	X	s	X	X	X	X	X	X	X	X	X	X	X	X	X	X	Z	X	A	A	O	O	O	O	O	X
X	X	X	O	X	X	X	H	X	B	X	s	s	s	s	s	X	O	O	O	O	O	O	O	O	O	X	O	O	O	O	X	X	X	X	O	X	X	O	X
X	O	O	O	O	O	Z	X	X	s	X	s	X	X	X	X	X	s	X	O	X	O	X	X	X	O	X	O	F	F	O	O	F	H	X	O	X	C	Z	X
X	Z	F	F	F	F	O	X	X	s	X	s	s	X	s	s	s	s	X	C	X	O	Z	K	X	O	D	O	O	X	X	C	X	Z	Z	O	X	X	A	X
X	O	O	O	H	F	O	X	X	s	X	X	s	X	s	X	X	X	X	X	X	X	X	X	X	X	X	F	O	O	X	X	X	F	F	O	X	O	O	X
X	X	X	O	F	F	O	X	F	s	s	s	s	X	s	X	R	A	H	V	V	V	V	H	A	A	X	F	F	O	O	O	O	O	F	O	X	O	X	X
X	O	O	O	O	O	O	X	F	Z	X	X	s	s	s	X	A	X	F	V	X	F	V	F	X	A	X	O	O	O	F	F	F	O	F	O	X	D	X	X
X	D	X	X	X	X	X	X	F	F	X	X	F	X	X	X	V	V	V	A	V	V	A	V	V	V	X	O	F	O	O	O	X	X	X	X	X	O	X	X
X	O	O	A	Z	F	O	Z	Z	Z	Z	X	O	K	Z	X	H	X	F	V	M	X	V	X	F	H	X	O	F	F	F	O	X	H	O	O	O	O	X	X
X	O	O	S	a	F	O	X	X	X	X	X	O	H	Z	X	H	F	X	V	X	M	V	F	X	H	X	O	H	K	F	O	X	F	O	F	F	F	X	X
X	O	O	O	Z	F	O	O	X	C	H	X	O	X	X	X	V	V	V	A	V	V	A	V	V	V	X	O	F	F	F	O	X	O	O	O	O	O	O	X
X	O	X	X	X	X	O	O	X	O	Z	O	O	X	R	X	A	X	F	V	F	X	V	F	X	A	X	Z	F	O	O	O	X	O	X	X	O	X	X	X
X	O	Z	X	O	O	O	O	X	O	O	X	X	X	O	X	A	A	H	V	V	V	V	H	A	A	X	F	F	O	X	X	X	O	X	Z	O	X	Z	X
X	O	X	X	F	F	X	C	X	O	O	O	A	X	O	X	X	X	X	X	X	X	X	D	X	X	X	O	O	O	X	Z	X	O	X	C	X	X	O	X
X	O	O	F	F	Z	X	X	X	O	O	O	K	X	O	O	O	s	A	a	K	B	X	O	X	C	X	X	X	D	X	A	X	O	X	X	X	O	O	X
X	O	O	F	F	Z	D	T	X	O	X	X	X	X	X	F	F	s	X	X	X	X	X	O	X	A	X	O	O	O	O	O	X	O	O	O	X	O	X	X
X	O	O	F	F	O	X	X	X	O	O	Z	O	O	X	Z	F	s	X	E	O	O	O	O	X	A	X	O	X	X	X	X	X	F	F	O	O	O	O	X
X	O	X	X	X	O	X	O	O	O	X	O	X	O	X	Z	F	s	X	X	X	X	X	X	X	Z	X	O	O	O	X	O	D	O	F	F	F	F	O	X
X	D	X	Z	Z	O	X	C	O	X	X	O	X	O	O	O	F	s	s	D	s	Z	Z	Z	X	Z	X	O	X	O	X	O	X	O	O	O	O	O	O	X
X	O	X	X	X	X	X	X	A	O	O	O	X	X	X	O	X	X	X	X	s	X	X	X	X	Z	X	O	X	C	X	O	X	O	X	X	O	X	X	X
X	O	O	O	Z	Z	Z	F	F	F	F	O	O	Z	X	O	O	O	O	X	s	X	s	s	Z	Z	O	O	X	X	X	O	X	O	X	O	O	Z	A	X
X	A	X	O	O	O	O	O	O	O	F	O	F	F	X	F	X	F	O	X	s	X	s	X	Z	X	X	X	X	O	O	O	X	O	X	O	X	X	X	X
X	Z	X	K	C	X	X	X	X	O	O	O	O	O	O	O	X	C	Z	X	s	s	s	X	Z	Z	O	O	O	O	X	H	X	Z	X	O	K	A	H	X
X	X	X	X	X	X	X	X	X	X	X	X	X	X	X	X	X	X	X	X	X	X	X	X	X	X	X	X	X	X	X	X	X	X	X	X	X	X	X	X
